####################
#******************#
#*################*#
#*################*#
#*################*#
#*################*#
#*################*#
#*################*#
#*################*#
#*################*#
#*################*#
####################
