####################
#*################*#
#*################*#
#*##########*******#
#*##########*#####*#
#*##########*#####*#
#************###***#
#*##############***#
#*##################
#*##################
#*##################
####################