####################
#*################*#
#*##########*******#
#*##########*#####*#
#************#####*#
#*###############**#
#*##########*******#
#*##########*#####*#
#*##########*******#
#*##########*#####*#
#************#####*#
####################
