####################
#*################*#
#*#####************#
#*#####*##########*#
#*####**##########*#
#******###########*#
#*################*#
#*################*#
#*##########*******#
#*##########*#######
#*##########*#######
####################